input_text	target_text	score
Sadly this is a hill they will die on, because it means admitting that "transitioning" doesn't really make you a woman, and they can't admit that.	I prefer it to the official app because it loads faster and has better customisations."	0.751
Runaway inflation. Potential stablecoin regulation that would cause a mega crypto correction. Housing market correction of around 10%-15%. Massive insider trading by our corrupt policymakers and of course the skyrocketing heart complications in young ppl from the largest experimental mass vaccination campaign in history.	<p>I&#39;m genuinely laughing.</p>	0.75
Rap is made by low iq people for low iq people	On a side note, when I was that little shit's age, I was being bullied by a kid at school and the teachers did nothing. He came at me one day and I smashed his face into a slide. He just needed the consequences one time to know not to fuck with me again. It had gone on for months before I decided to take it into my own hands and my dad had already said something to the kids parents. They did not care because their precious little boy ""liked"" me and that's why he acted that way. Big noooooooope. Be better or get your face smashed into a slide."	0.86
Let‚Äôs pray that this never becomes truly illegal. Abortion is a necessary part of life	<p>Most people who &quot;choose&quot; to live like this have serious mental health issues, and aren&#39;t simply asocial. Honestly your post comes off very condescending, but the arguments are superficial. I find this surprising given the massive amount of recent studies surrounding isolation in the current pandemic. Try going a week without speaking to another person. That means no emails, text messages, chat, video games, phone calls, etc. You might find that it sounds much easier than it actually is.</p>	0.799
Men carry seed, which gets planted in that empty egg.	Hope your smart glasses start up goes well"	0.819
Can you please define the male and female genders without using stereotypes?	Sad you&#39;ve tossed aside so much - and right at the end too.<br/>	0.751
Main Stream Media pushing the narrative of their owners.	I'm a believer in Jesus but I adore the Jewish doctrine. Shame so many Christians don't read the old testament. Same analogy goes for me to them. They try to tell me doctrine but they didn't read 3/4th of the book. It's just absurd. Feel alone. I literally never met one person who believes what I believe. Mocked and ridiculed continuously.	0.829
You are going to end up feeding her though a straw for a while so I think you should get a say too	<p>If we just got rid of ICE, we basically have The Hunger Games/Elysium.</p>	0.61
However it worked out,	<p>One of my favorite people was diagnosed with AIDS in 1992 and has no detectable viral load today. AZT and an amazing wife did that. He writes for POZ magazine, he performs regularly as an artist here, and he would never say that children should have their genitals mutilated.</p>	0.797
wish harder then	<p>&quot;Aliens? Us?! Is this one of your Earth jokes?!?&quot;</p>	0.732
Boris Johnson becoming PM of England lol	So, I'm saying that there's no point complaining about job adverts... They're for unambitious people. Create your own job and charge whatever rate you can."	0.818
Happens at the hands of religious people, and always directed at atheists more than any other group.  Religion is the definition of ignorance and fantasy. Many parts of the world would  murder me in the streets for saying any of this, what fun an intelligent people the religious are. Plus they have the best hats.  Fun.	<p>If this is the new breeding ground for ideological stupidity and/or crazy, we are all fucked.</p>	0.847
I know exactly who I'm replying to.   If it makes no sense to you, it only shows you are way out of your depth trying to understand the big, philosophical, religious questions in the first place.   I confident anyone else reading what I'm saying will know exactly what I'm getting at, even if you don't.	However, i made a point of not going there if I was in a relationship. It was sort of a post-breakup routine for me - once I stopped crying after splitting/dumping/being dumped by my GF, I go to get fucked by men, not looking for another relationship for several months, then I find a GF, date her, stop going on romps. However, once I was in my mid 30's I started feeling quite insecure about my looks, so I stopped going to such places and stated relying on my toys to get me through."	0.88
Ubisoft steamworks goes bye bye always on drm Ubisoft steamworks goes bye bye always on drm Ubisoft steamworks goes bye bye always on drm Ubisoft steamworks goes bye bye always on drm Ubisoft steamworks goes bye bye always on drm Ubisoft steamworks goes bye bye always on drm Ubisoft steamworks goes bye bye always on drm Ubisoft steamworks goes bye bye always on drm Ubisoft steamworks goes bye bye always on drm Ubisoft steamworks goes bye bye always on drm Ubisoft steamworks goes bye bye always on drm Ubisoft steamworks goes bye bye always on drm Ubisoft steamworks goes bye bye always on drm Ubisoft steamworks goes bye bye always on drm Ubisoft steamworks goes bye bye always on drm Ubisoft steamworks goes bye bye always on drm Ubisoft steamworks goes bye bye always on drm Ubisoft steamworks goes bye bye always on drm Ubisoft steamworks goes bye bye always on drm Ubisoft steamworks goes bye bye always on drm Ubisoft steamworks goes bye bye always on drm Ubisoft steamworks goes bye bye always on drm Ubisoft steamworks goes bye bye always on drm Ubisoft steamworks goes bye bye always on drm Ubisoft steamworks goes bye bye always on drm Ubisoft steamworks goes bye bye always on drm Ubisoft steamworks goes bye bye always on drm Ubisoft steamworks goes bye bye always on drm Ubisoft steamworks goes bye bye always on drm Ubisoft steamworks goes bye bye always on drm Ubisoft steamworks goes bye bye always on drm Ubisoft steamworks goes bye bye always on drm Ubisoft steamworks goes bye bye always on drm Ubisoft steamworks goes bye bye always on drm Ubisoft steamworks goes bye bye always on drm Ubisoft steamworks goes bye bye always on drm Ubisoft steamworks goes bye bye always on drm Ubisoft steamworks goes bye bye always on drm Ubisoft steamworks goes bye bye always on drm Ubisoft steamworks goes bye bye always on drm Ubisoft steamworks goes bye bye always on drm Ubisoft steamworks goes bye bye always on drm Ubisoft steamworks goes bye bye always on drm Ubisoft steamworks goes bye bye always on drm Ubisoft steamworks goes bye bye always on drm Ubisoft steamworks goes bye bye always on drm Ubisoft steamworks goes bye bye always on drm Ubisoft steamworks goes bye bye always on drm Ubisoft steamworks goes bye bye always on drm Ubisoft steamworks goes bye bye always on drm Ubisoft steamworks goes bye bye always on drm Ubisoft steamworks goes bye bye always on drm Ubisoft steamworks goes bye bye always on drm Ubisoft steamworks goes bye bye always on drm Ubisoft steamworks goes bye bye always on drm Ubisoft steamworks goes bye bye always on drm Ubisoft steamworks goes bye bye always on drm Ubisoft steamworks goes bye bye always on drm Ubisoft steamworks goes bye bye always on drm Ubisoft steamworks goes bye bye always on drm Ubisoft steamworks goes bye bye always on drm Ubisoft steamworks goes bye bye always on drm Ubisoft steamworks goes bye bye always on drm Ubisoft steamworks goes bye bye always on drm Ubisoft steamworks goes bye bye always on drm Ubisoft steamworks goes bye bye always on drm Ubisoft steamworks goes bye bye always on drm Ubisoft steamworks goes bye bye always on drm Ubisoft steamworks goes bye bye always on drm Ubisoft steamworks goes bye bye always on drm Ubisoft steamworks goes bye bye always on drm Ubisoft steamworks goes bye bye always on drm Ubisoft steamworks goes bye bye always on drm Ubisoft steamworks goes bye bye always on drm Ubisoft steamworks goes bye bye always on drm Ubisoft steamworks goes bye bye always on drm Ubisoft steamworks goes bye bye always on drm Ubisoft steamworks goes bye bye always on drm Ubisoft steamworks goes bye bye always on drm Ubisoft steamworks goes bye bye always on drm Ubisoft steamworks goes bye bye always on drm Ubisoft steamworks goes bye bye always on drm Ubisoft steamworks goes bye bye always on drm Ubisoft steamworks goes bye bye always on drm Ubisoft steamworks goes bye bye always on drm Ubisoft steamworks goes bye bye always on drm Ubisoft steamworks goes bye bye always on drm Ubisoft steamworks goes bye bye always on drm Ubisoft steamworks goes bye bye always on drm Ubisoft steamworks goes bye bye always on drm Ubisoft steamworks goes bye bye always on drm Ubisoft steamworks goes bye bye always on drm Ubisoft steamworks goes bye bye always on drm Ubisoft steamworks goes bye bye always on drm Ubisoft steamworks goes bye bye always on drm Ubisoft steamworks goes bye bye always on drm	hebrew	0.764
I‚Äôm not especially claustrophobic but that is terrifying.	<li><p>The Strangerers. It was a comedy starring Mark William&#39;s and Jack Docherty as aliens in human form sent to Earth to learn about Earth culture. </p></li>	0.793
I‚Äôm sorry to say this‚Ä¶ but I hope you step on a Lego lmao	Over the years he‚Äôs relaxed and allowed me into their home, and he comes to cookouts	0.787
I showed my bare penis to my mailman when he wasn't ready, and he freaked the fuck out at me and said that it was below average in size, and looked ugly because it is uncircumsized :(  It has really messed with my self esteem... I am thinking about those words every day it seems	2) bath.	0.761
Well yeah, but only having fried chicken is not enough of the stereotypes to make it racist.	Good luck getting you banned? Lol kid, you're REALLY easy to set off. You think I can't piss you off so much you start saying shit that'll get you banned? Try me"	0.791
I learned to forgive	<p>So go ahead and whine about your &quot;rights&quot; all you want. Just be thankful you have the rights you currently enjoy, too, and stop acting like the US is some terrible place just because we don&#39;t pay for your sex change surgeries.</p>	0.788
Bye snowflake.	<p>A good friend of mine was attacked by her machete-wielding husband. He cut her arm down to the bone, and was coming back for another strike at her head when she pulled her pistol and shot him once in the chest, killing him. He was literally winding for for the killing blow against her, while she was holding their daughter. And you&#39;re telling me it would have been morally superior if she had just let him kill her and perhaps the 4 year old daughter too? He never knew she had a gun. He had been acting more and more unstable for months, so she bought a pistol and got her license to carry it. He attacked her because she served him divorce papers. He just reached into the corner, grabbed the machete and swung in about a second. He was going to kill her for trying to divorce him and get away from him. But you&#39;re telling me she&#39;s in the wrong because she used a gun?</p>	0.855
Be a security gaurd	Black t shirt with jeans"	0.735
White	Shut them down. Respect is earned. Best part is, it's cheap.	0.746
Learn emergency rescue	Just poop it out of your system"	0.789
He wasn't carrying his reverse uno card on him.	<p>edit: I&#39;ve worked several 9-5 office jobs before where I could afford stuff and had 5w of holiday every year. But I hated the work. Not for me that life.</p>	0.839
You're not going to buy it haha. You can't. And even if you did, you'd end up killing yourself and a full city or country with a horrible, painful, death.	genna	0.881
blatant disrespect	The first 2 days I slept the entire time waking up only to take medicine. I haven‚Äôt gotten out of bed since really. Now it‚Äôs just the tiredness and cough left."	0.871
Coraline	Fast forward 2020 (shit year), soc med announced that ""new"" Nips Fruit & Nuts and I remember seeing it at the store and saying ""that ain't new, I used to buy this a lot before."". But no one knows about it and they insist that it's new even if I know that it's not. Idk but sometimes it makes me question my damn memory because of a fucking candy that no one (from my circle) remembers except me."	0.817
Vice-principal of my kids' school was named Chris Peacock. As if that wasn't bad enough, he named his own son Andrew. Drew for short.   Say it out loud.	Make a coffee.	0.854
>Second, try to create something just like Qur'an, do not copy it  Rig Veda, Book 1 Hymn 1 1 I Laud Agni, the chosen Priest, God, minister of sacrifice, The hotar, lavishest of wealth. 2 Worthy is Agni to be praised by living as by ancient seers. He shall bring hitherward the Gods. 3 Through Agni man obtaineth wealth, yea, plenty waxing day by day, Most rich in heroes, glorious. 4 Agni, the perfect sacrifice which thou encompassest about Verily goeth to the Gods. 5 May Agni, sapient-minded Priest, truthful, most gloriously great, The God, come hither with the Gods. 6 Whatever blessing, Agni, thou wilt grant unto thy worshipper, That, A·πÖgiras, is indeed thy truth. 7 To thee, dispeller of the night, O Agni, day by day with prayer Bringing thee reverence, we come 8 Ruler of sacrifices, guard of Law eternal, radiant One, Increasing in thine own abode. 9 Be to us easy of approach, even as a father to his son: Agni, be with us for our weal.	Burrito or a Hot-n-Ready</p>	0.673
I absolutely agree with the general idea of this, but weight is absolutely not the only factor that needs to be taken into account. same as sex not needing to be the only factor taken into account	<p>Also, Jurassic world: camp Cretaceous. So damn good.</p>	0.745
Sounds like you‚Äôre fat but see yourself as really nice?	It‚Äôs a stupid time	0.962
Enjoy itüòÇ	<p>Imagine living in the 1970‚Äôs, beauty standards had barely been formed, no social media &amp; everyone is relatively clued into the world around them. Not to mention the plethora of music genres that get introduced over the next 20-30 years.</p>	0.745
Pretty much nightly for most of my life	I got a reply saying I was ""Objectifying"" AOC.	0.833
No mean yes  Yes mean anal	Vanellope	0.858
I know I would. It was my best friend and I love her to death.	And I know I'm making something out of this life they called nothing"""	0.807
I have had two separate women tell all of their friends that they were deeply unsatisfied with the size of my penis shaft, and tell them all I am uncircumsized so that they would be repulsed by me	The Live-Action Avatar from Netflix will probably suck, but it's the **only** Avatar project Nick will greenlight. Because it doesn't ""compete"" with their bread and butter - Animation. Now the possibility does exist that with the live-action *being* successful, that, that will cause Nick(or Viacom really) to take another look at the series and possibly greenlight a third series, but for Paramount Plus(their streaming service).	0.743
What if i store it in a very secure box?	Funny story, I do not think that‚Äôs the case *everywhere*, as I have absolutely had the displeasure of drinking sweet tea that was mistakenly brewed with *sprite syrup*. 0/10 would cut out my tounge"	0.843
I am	<p>With nukes on the table, a &#39;total&#39; victory where you take their capitol or invade deep into their territory is not going to be viable. This is why many wars in the latter half of the 20th Century have been proxy wars.</p>	0.801
Turkey Sandwich	Having a shower and setting the shower head to a strong/narrow setting (if you can on your shower head) and just have that between your eyes/top of nose for a while also seems to help get rid of it for me too."	0.748
i don't think people singing along are being racist, at least not everyone but just whenever any white person says the n word for any reason is bad. i never said people not being racist is cringe, i said people skipping lyrics is cringe.	<p>good theyre gone now</p>	0.808
For me that's what makes it hot.	Games:	0.815
Become a politician	<p>May you go forth and use the correct phrase to even greater effect than before! üòé</p>	0.637
Believe them..	2) Tear off the top quarter of wax paper to create your high tech handheld butterstick device	0.732
Left leaning: There are only two sexes. GTFO with the gender issues. You can't feel your gender. If you're a man who likes woman clothes, you're still a man, but with a different taste of clothes.	I genuinely don't think I would assume that...."	0.915
You missed my point.   If there is no God, then there's no way of knowing what is 'moral.' You would only have an opinion on what is moral. Other people may have a different opinion. Who is really moral? You wouldn't know without God.	The toenail:	0.77
I have lmao	(Grabs popcorn)"	0.614
Love it ‚ù§	I'm a girl."	0.777
Posts semi nudes for attention & gets mad when people act on it	At least we both remained civil.	0.647
Garlic chicken.	<p>So because she&#39;s not fiscally responsible and blew through millions of dollars in just a few years she&#39;s decided to destroy a man&#39;s career, reputation, and future just so she can have enough notoriety to bargain for bigger paychecks with.</p>	0.842
Serena at some point played a man ranked somewhere around 200th best. I‚Äôm paraphrasing here, but I think she said something along the lines of ‚Äúits not even the same sport‚Äù	Doesn't sound delicious"	0.913
fragile bslur detected	DO IT!!!"	0.93
And you fucked that type of guy. Thanks.	<p>I like the way you think.</p>	0.8
Im transgender	PS: There's no such thing as ""a perfect girl"" as you said you were looking for. There's no such thing as a ""perfect"" anyone. Are you perfect? Fuck no. So don't expect some chick you meet in the produce aisle or on Tinder to be perfect either. Just go thru a few (or a bunch) of relationships first and see what matches with your personality and how yours matches with theirs. Perfection literally doesn't exist so don't set the bar at some impossible/imaginary/unobtainable level. That's just setting yourself up for disappointment. There's ""pretty damn good"" and it just goes down from there. But there's no ""perfect"". Because humanity isn't perfect by nature. Plus you gotta run through a bunch of batshit crazy first before you can appreciate a mostly sane and well adjusted girl."	0.816
I heard her hooha stinks too.	Also,  I miss Arby's. We had some when I was a little kid, went to one only once, but those fries were crazy awesome, then they left the country :( Also like many kids I was silly and refused to taste  the roastbeef sandwich because the word ""roastbeef"" to me sounded like it was made of shoes or something gross."	0.864
Pretty high given the current administration.	That‚Äôs exactly what I‚Äôm saying.	0.918
You thought that post was so terrible you felt the need the stalk their profile?	<p>First, I close my eyes and take a large inhale through my nose. Then, slowly exhale through my mouth while consciously relaxing the muscles in my face, jaw, shoulders, whole body. If I‚Äôm really tense I might need to do this a few times. </p>	0.737
What? She died so as to not ruin everyone's year? This has gotta be the dumbest shit on reddit I've ever seen. Eat rocks, dipshit	Her &quot;then what are you!?&quot;	0.828
Most women still expect men to initiate.	That's the problem, he doesn't. He hoards it, then borrows against it to buy another yacht, or go to space. Jeff Bezos has the wealth and experience with shipping infrastructure necessary to end world hunger. He wakes up every day and doesn't, if it even crosses his mind. That's evil. The Walton family made enough in profit in 2019 to pay each and everyone of their ""associates"" (employees) $30,000 more than they do. That would change each and every one of their lives for the better, that money would circulate in the economy, be taxed to go toward important government programs at every level, allow them to send their children to college without crippling them with debt so they can have better lives. The Waltons choose not to in favor of opening another art gallery that they and their rich friends can enjoy. That's evil.	0.849
Very dumb.	<p>I‚Äôll hopefully find something. Our company doesn‚Äôt believe in WFH so that‚Äôs one incentive  at least to start looking elsewhere.</p>	0.791
I am left, but believe transgender athletes should not compete with females	<p>Enjoy life is okay, but it&#39;s only a neccesity more of the body, we can enjoy as well as work a meaning life. Pleasure shouldn&#39;t be an entire objective for us, because it&#39;s subjective and unreal.</p>	0.833
Your slur has less value than the Turkish lira at this point. I got pussy too you know, I'm worthy if that's your way of evaluating people, my sweet androgynous Casanova soyboy. Ironically, being around girls and their androgynous boyfriends with thighs the size of my biceps is what shaped my convictions	And inquisition and had the best companion/companion arcs. Pretty sure I like them more than I like my irl friends üòÇüòÇüòÇ	0.836
If she has pronouns in her bio	Panasonic makes earbuds for under 10 bucks, and they just, won't, die. Most cheap earbuds die out within weeks and sound awful. I think I've used these ones for like 2 years now. Accidentally stepped on em a few times, got em all tangled up. Everything that would break normal earbuds. But nope.	0.827
I'm already married to that person	<p>I dont get how its popular. it doesnt have much taste to it.</p>	0.869
Coworker loved r/spacedicks.	RIP"	0.815
k	<p>Also, treat taking care of your teeth and mouth as a regular and necessary daily routine, even if you already have a lot of dental problems, it&#39;s not too late to at least make it less severe down the line. Most dental disease is caused by bacteria, and if you fight the bacteria, and the advice your dentist gives you is to fight them off. I&#39;m a dentist who has experiences a lot of dental problems in my youth, but I learned that even though you can make things SIGNIFICANTLY better if you follow the usual advice:</p>	0.813
You'll know once I stop commenting.	Feel Good Inc. - Gorillaz	0.652
"white opinion" you don't get to have an opinion on black people's business. however might i ask why people not being racist is cringey to you..?	<p>Source - my grocery receipts.</p>	0.665
> The Hive scene in Aliens. >  > Like why the fuck would you go into that and then not tell the marines why there aren't allowed to fire their guns üò≠ yes I know plot demands it's but still.	I make money playing it.</p>	0.711
The average man has Olympic level grip strength compared to women	It‚Äôs easier to go without a lot now to save and invest for a better future than it is to try and play catch up."	0.822
rofl...says the 40+, overweight, broke single mom from manchester.  cute dog tho.	I spent a great portion of my life in prison and hate cops more than anyone I know but during that time in prison I studied the us law system this premeditated case will not stick I promise you and as a result the man will walk. The prosecution has the burden to prove without a reasonable doubt that the officer killed Floyd with premeditated intent. That is going to be impossible with Floyd being a junkie. I‚Äôm not saying it‚Äôs not very possible but it‚Äôs impossible to prove. If you are truely ‚Äútrained‚Äù or w/e your hinting towards focus more on the courtroom side of things and learn laws we need more cops on the streets that know those things not thugs with guns. I‚Äôm sorry you want to see this cop get life for this but trying to push the racial woke agenda this is not the right case for it."	0.839
Don‚Äôt be a dick man. For the most part I could care less about celebrities, but some have an impact on people from many different decades and it hurts when they die.	Yeah here 'shrooms are decriminalized here but you can't buy them or give them to someone else...a society should really be embarrassed about having policies like that. ""Okay it isn't legal but we'll make it a low priority...also federally we can still lock you up if randomly we feel like it."" And people wonder why laws and police aren't taken seriously. It's too arbitrary and hypocritical to respect. That's why they gotta put a gun in your face."	0.866
Yikes.	how are you finding reddit	0.71
Great news!!	<p>I mostly watch Gumball and Craig of the creak, they are entertaining enough for me atleast.</p>	0.855
He can't make decisions	Pull the sheets up.	0.604
I think therapy is a valid choice for children questioning their gender identity. I‚Äôm not sure if that would be considered conversion therapy.  I don‚Äôt think people should be able to walk into a doctor‚Äôs office, say they‚Äôre transgender, and then be handed life-altering hormones. I don‚Äôt know the process so that‚Äôs probably a drastic oversimplification.	How I Met Your Mother	1.0
Gather samples	If you want to leverage the power of a government, use it for infrastructure improvements to adapt to the changing climate. Because changing it is, and changing it will continue to do. The hope of stopping it, or really even slowing it down, is pretty clearly not realistic, or SOMEONE would have done something. But instead we have the world's largest example of bystander syndrome, where everyone is convinced it's not their problem to solve."	0.848
As a teen, watching teen shows and seeing all the characters making friends, going out, and forming relationships, meanwhile I sit at home and do nothing all day.	Haha but funny meme haha	0.944
Lol	<p>You see, when you are fat, you are usually stretching your stomach with every big meal. Over time, your stomach gets bigger than average. Then, when you diet, you have a large empty stomach and that can add to your feelings of hunger which are unpleasant. But if you fill up on water or fiber, you can offset this temporarily. Over time of eating smaller portions and working out, your body will naturally shrink your stomach down to match this new diet a bit better, so smaller portions will make you feel more full!</p>	0.806
[Maybe the answer can be found at postmandeliveries.]	<p>My theory is that most of the people will order at least one meal because people have developed irrational ideas about what it means to starve, and even though they know they&#39;ll be done in 5 days and that there is no way they&#39;ll die or really have anything happen to them except feeling shitty, their mind will convince them that their life is in danger. </p>	0.858
That's a great one	<p>And anything followed by ‚Äúbut‚Äù.</p>	0.732
I agree with this for this year! But we got this!	Late Spring	0.756
[removed]	<p>When bullied I learned that violence is a great solution.</p>	0.745
In this specific case no one is calling you a slur except your own race. If you are singing along to a song with said slur in it you are not using it as a slur you are using it as a form music. There is a big difference between using the word as a form of racial discrimination, and saying it while singing along to a song.	>If women don't like you, maybe you're a shitty person.	0.796
I agree.	<p>John&#39;s dad. Mary&#39;s mother. Grimley&#39;s other parent. My son&#39;s father.</p>	0.678
Probably accidentally replied to the comment instead of posting their own	<p>Like I said, next day I was here.</p>	0.81
Black Toast. Honestly? Not awful. Could be a cool surrealist vibe.	Ebay is actually now offering fee free sales if you promote and advertise them yourself, so theoretically you could set up a Shopify store with fee free links to your ebay items and you would be getting the best of both worlds that way without the need to effectively ‚Äúcross list‚Äù	0.742
Right	And the only time her songs ever come across as ""real Taylor"" to me is when she's got a ""why doesn't everyone just LOVE me like they're supposed to?"" gripe going on (like ""Mean"", ""Shake it Off"" or ""Look What You Made Me Do""), and her best songs always seem to come from a place of ""rich girl with no real problems"" (like ""Style"" and ""Delicate"").  Everything else seems carefully crafted to make her look down-to-earth and it's never felt sincere to me."	0.774
My pc	<p>Honestly the worst part is I could easily get back into it and learn everything again in a couple weeks, but my motivation is gone. It used to be an activity that brought me joy but after going to therapy and forcing myself to push that down in favor of other things its just not fun anymore, and I just don&#39;t have the energy/ motivation/ drive to do it anymore so I just end up picking it up strumming a few cords and then putting it down because what&#39;s the point.</p>	0.877
Omg you seem pressed that I spilled the beans. Hahaha üòπ you‚Äôre pathetic  You even reported me? If what I‚Äôm saying is vullshit why would you even give me attention?  To top it off you insult me. So I must of hit a spot with you	<p>I didn‚Äôt have to do yearly tests</p>	0.707
Teen vag.	> If I re find the video we used I'll link it	0.758
I'm fine, thanks for the concern. If you don't care about my opinion, why go to the trouble of responding at all?  People who don't give a fuck don't make the effort you just did.	>in	0.804
What do you mean 'no?' Are you not sure?	Besides that they're all good ig"	0.862
Serious question: how much of an actual problem is this? Like, is this completely manufactured by Pearl clutching news outlets, or is there actually an army of young men ready to cut their dicks off to win a track meet?	Your earrings are gorgeous.	0.729
maybe it‚Äôs the dog‚Äôs name	<p>We have three kids, been together for almost a decade now.</p>	0.815
Lol	<p>I personally do not subscribe to a lot of the political beliefs of the right.  I&#39;ve not once voted for a republican president.  Yet I still support free speech and open discussion of opposing viewpoints.  I am open minded and will willingly change my stance on an issue if I&#39;m presented with factual evidence to the contrary of my beliefs.  You have not done that here.</p>	0.832
You alright mate?üòÇ	Reason I haven‚Äôt seen a doctor? There‚Äôs not really a cure and it‚Äôs nothing to do with your eyes but rather things misfiring in your brain."	0.806
Gaylord Focker is probably the worst I know of. I heard he got married and had a couple kids.	Don‚Äôt send pics of your junk. Seriously, don‚Äôt. Just no.	0.853
Comment bot	<p>If I admit to brake something I never got in trouble, as they said.</p>	0.804
Your kid was having fun joking around and your a fucking asshole	Thank you"	0.947
Abraham Lincoln. He might've gotten Reconstruction to work.	Yeah .. you're right :)"	0.954
The point is that gender and sex meaning different things is not an objective fact. It is a definition created by a small group of sexologists that has gained *some* support and common use, but I would be willing to bet that the majority of English speakers (going beyond the Reddit/Twitter bubble) think of gender and sex as being the same thing. So linguistically, your definition certainly can count as an alternative definition, but the word has certainly not undergone a full shift in definition.  And there was no "discovery" that gender and sex are different things. A few sexologists just up and decided that from now on gender meant gender identity, and sex meant biological sex. And that's the thing, we already had a perfectly good term: gender identity. Why do we need to change the meaning of the word gender?	<li><p>Suetonius and Pliny the Younger (112 CE, governor of Bithynia) both call the idea that Jesus was raised from the dead a &quot;mischievious superstition&quot; and a &quot;disease.&quot; Suetonius records Hadrian blaming a person named &quot;Chrestus&quot; (commonly considered to be in reference to Christ) for &quot;disturbances,&quot; namely not worshipping idols and loving everyone, including their tormentors. In a work that was not his biography, Suetonius also talks about the fire in 64 CE which Nero blamed the Christians for, and then his new punishment for them became burning them alive in his garden. Pliny suggested methods for dealing with the Christians to Trajan.</p></li>	0.769
This is true, but many trans women are shorter than many cis women. If height is the real issue, then why are we talking about gender at all? Not to mention that hormone levels in trans women are tightly controlled, which is not the case for cis women. This means that many cis athletes actually have *higher* testosterone levels than their trans counterparts. As it stands, the current regulations are working, and rather than seeing trans women dominate (as some would have you believe), we actually see trans women winning less often than their cis counterparts, even when adjusted for population size.  In the end, this is an issue that has been basically solved already, and is mostly just being used as a culture war issue to win seats for politicians.  One more side note: "a transgender" is not really the preferred wording. It comes across a little dehumanizing, like saying "a black" to refer to a black person. Transgender is an adjective, so it doesn't really work as a noun like that. I am not "a transgender", I am a transgender woman (or a trans woman, or even just a woman).	Except Chili Mac. That was so delicious on its own."	0.745
Is there?	<p>TITANFALL 2 FOR LIFE</p>	0.692
[Maybe the answer can be found at postmandeliveries.]	It‚Äôs not you."	0.715
You're not even man enough to walk away from a comment you dislike.	<p>Probably because the obvious follow up question to this (in my head at least) would be &quot;anything in particular you like?&quot; Because of the stigmatisation of being overweight, there&#39;s a bit of a worry that complimenting a woman for their curves might be interpreted as &quot;you&#39;re fat but still kinda hot&quot; or just as negging. I think a lot of guys latched on to &quot;thicc&quot; because it&#39;s explicitly intended as a compliment for that particular body type, even if it is a bit of a crude one</p>	0.714
Sounds entertaining if you‚Äôre into shin bruises	(I like their one better)</p>	0.754
Your mum	Jeff Bezos made jobs, yes. They are mostly bad job, those ""claims"" have been substantiated over and over. He could make things better for his employees, pay them more, better benefits, better conditions, more employees to share the load, but it would cost him more money, so he doesn't. It is more affordable for him to run anti-union campaigns and just churn through employees, use them until they break then hire new ones, than make things better for those he already has. They didn't ask for that job, they *needed* a job and he controlled the only one available to them. You can afford to make those other arrangements, someone making $10 at 38 hours so they don't get insurance can't. Their livelihoods are held hostage by the man who controls their jobs, because he pays them the bare minimum to keep them in their place: more than other place, less than they need to get out. That is exploitation.	0.85
Doing alright	Now the two biggest reasons probably are that I end up loving people who don‚Äôt give two shits about me. They like what I am able to do for them, but they never actually want to just be with me. And the second being that I don‚Äôt know how to express emotions properly because its not like it‚Äôs something you are taught."	0.86
What is the difference? They're all connected! I'll call a plumber right now!	China invades Taiwan, America defends Taiwan. China is taking heavy losses, so they invade a nearby japanese island so they have a foward base closer to Taiwan. Which brings Japan into the war (which doesn&#39;t bother China that much since Japan was already sending data and supplies to US troops. Also Japan has a defense agreement with the US anyway).	0.743
So true.  Any opinion that's actually unpopular with the woke internationalist reddit crowd will just get you banned or suspended, unless it's something totally non political and non social like saying you like putting chocolate sauce on your steak.	<p>Off to Hell then.</p>	0.779
https://socialiner.xyz/829875296611 REGISTER 25USD  FREE$$	‚ÄúI wish I had a boyfriend like u‚Äù</p>	0.903
Lol. We come from our fathers balls so our father would have to have sex with another women to have us	Those are probably my top 3."	0.713
Myself	If you have the wrong opinion, doesn't matter how much you contribute to the discussion. Down you go."	0.843
Problem is trans individuals make up less than 0.5% of the population or as much as 3% of the population depending on age.  So how does one make it fair when the total number of athletes means there's only 3 or 4 trans people?  You can't even make a basketball team with those kinds of numbers.	Best damn thing that ever happened to be so far."	0.913
The White Album is my fave regardless.	I haven't seen it - what's confusing about it?"	0.806
Cocain works by keeping the transporters from mopping up the dopamine.	<p>A large amount of the time is spent covering how bad America is and how crazy it is. Literal documentaries about people dying left and right from gmo food products, Race riots, LBGTQ people causing mayhem etc. I would often get asked by Russians about obscure news stories that happened in America. </p>	0.829
Always ‚ù§	Telekinesis."	0.684
Peer review doesn't work when all of your peers are subjected to the same propaganda, or fired if they don't buy into it.	Not an excuse to act how I want, I mean everyone is gonna judge you anyway so why not do what you want.</p>	0.833
Drake fucking sucks!	An acquaintance of mine who will just start masturbating in front of me without warning."	0.793
What was ruined because too many people started doing it? Well, how about this exact same question appearing on the front page of Reddit every fucking week for a start?	<p>I&#39;d go to work in the warehouse and the perfectly straight aisles of racking would seem to have a long sort of curve, or the world would seem to be tilted 45¬∞ to the side. There was near constant movement at the corners of my vision that I could never focus on, and at night the shadows would all be moving.</p>	0.784
So having spiritual belief is mental illness but a male believing he is woman isn‚Äôt?	Just because you think something is a certain way in another perspective it might be the complete opposite most likely your perspective is shitty and you are bad yourself"	0.876
This is my post and I care about it. You are just in it, engaging with me. So I'm replying.  You don't seem okay.	Mad World by Gary Jules	0.763
Don't assume I don't have a job just because I'm black.	‚ÄúYer gonna make me cum, or I‚Äôm gonna kick yer butt‚Äù</p>	0.769
Carpeted bathroom	Toxic positivity. Embrace the things about you that are bad, recognise them. Thats the only way youre going to chase self improvement.	0.803
You say I‚Äôm projecting next thing you do is claim i said something I never said.  I never said there aren‚Äôt women who like mature guys  The world is sad because people like you have anger issues and can‚Äôt hear a different opinion without throwing a tantrum	<p>My father in law took out the old flathead in the 1040 mercury coupe. </p>	0.697
> active in r/autism	freaky deaky type shit</p>	0.859
I'm white. She never said a word to me about it at the time but it hit me the next morning how terribly inappropriate that was and it took me a full year to work up the guts to even bring it up enough to apologize. She was really nice about it, too, which made it even worse.	What does this mean? I don't think I get it"	0.941
just become a pornstar	Having two car payments is a serious financial burden for most families. Add child care to the mix and most of those families will be breaking even. It's pointless. So why do they do it? I have no idea, other than the fancy new car looks cool or something, and that $600+ a month in extra expense must be paid for somehow."	0.854
Then even after she apologizes she was like, I was so afraid of losing you and the family. Like what? What does even make sense. You were afraid of losing your family‚Ä¶ presumably through death or estrangement as that‚Äôs how you loose your family‚Ä¶ that you held them to an impossible standard and told the second to youngest she was hurting the family??? What? That makes no sense.	Carry On-fun.	0.849
Damn	<p>Lego set.</p>	0.727
