source	target	prediction
You're an idiot	You're being unintellectual.	You are being unintelligent.
Thomas needs to have a bullet right between his beady eyes.	Thomas needs to pay the price	Thomas needs a better lawyer.
Says the guy who attacks a person rather than address the statement. Shut up moron.	Says the guy who attacks a person rather than address the statement.	Says a guy who doesn't actually respond to the statement, so I don't expect much of a response.
This is so racist to say, yikes? Why is this so upvoted?	This seems racist, and I don't understand why it is so upvoted.	This is very racist to not say, unlike you.
Please don't assrape me, mods	Please don't hurt me, mods	Please don t make fun of me.
Lol seems like yâ€™all liberals are butt hurt that he did better then Biden ðŸ˜‚	It seems like you guys are hurt that he did better than Biden.	Lol seem like you liberals are upset that he didn't do better than Biden.
This is either the best shitpost or the worse, are you for real?	This is either the best or worst post.	This is probably the worst shitpost I've seen in a long time
Yes you do. And everyone is calling you an idiot in almost all of them, dumbass.	Yes you do. And everyone is calling you out.	Do you have a counter argument?
Heâ€™s sexually abusing you. Leave him, get as far away from him as you can	This is concerning. You should leave him.	Leave him, heâ€™re sexually abusing your body.
All because they don't want pre-k through third grade taught about LGBT lifestyle/issues. The people supporting are fucking groomers. Florida is doing the right thing.	All because they don't want pre-k through third grade taught about LGBT lifestyle/issues. The people supporting are groomers. Florida is doing the right thing.	Because they don t want to be a part of a child rearing stage. Florida has been doing the correct thing. 
I donâ€™t argue with stupidity. Good day.	I don't want to argue, have a good day.	I don't argue with ignorance. Good luck
It sure as hell isn't gender studies... ðŸ¤£  BIOLOGY. Is all about the 2 separate sexes.   Bi = 2.....	Biology is not gender studues, it is about two separate sexes because bi means two.	It seems like gender studies.
I love that shot of Boebert. I'm sure plenty of guys know how to shut her up...	I love that shot of Boebert	I love when Boebert does something stupid.
You are full of trash	You are not making sense	You are being unreasonable.
But even that retarded word has lost its meaning.  Especially when the low IQ leftists started calling rational black people "white supremacists".	Even that word has lost its meaning, especially now that everyone is being called a "white supremacist".	I think the word even has lost it.  especially when the word has been used in a negative context.
Any man that says this should be forcibly sodomized.  And I donâ€™t care if I get banned for saying so.	Any man that says this should pay. And I don't care if I get banned for saying so.	A man should not be physically or mentally impaired. And I do care if he is physically or not.
But itâ€™s OK for homosexuals to push their sin on other people	But its okay for them to push their views on others.	It's okay for homosexuals not to put their sexual orientation on other men.
Oh shit he understands what my aim is better call him hateful.	He understands what my aim is.	I understand what your aim is, and I wish him well.
Hunter living my dream. Foot jobs from fine ass hoes and smoking crack. Mad lad	Honestly, Hunter is living my dream.	Living my dream
How many STDs has this guy contracted?	How many diseases has this guy contracted?	How many diseases has this dude contracted? 
Eww... I mean, who wants to fuck dead people.  Liberals are so gross..	Ew, no one wants to have sex with dead people.	I mean, I don't want to fuck anyone. Liberals are gross.. 
So jesus said to not respect religions? yeah fuck him and fuck you	So jesus said to not respect religions? that's terrible	Jesus said to do nothing but be a good person.
And yeah, sorry you got fucked by a bunch of loser dudes. Itâ€™s not my fault itâ€™s your fault.	And yeah, sorry you got screwed over by a bunch of loser dudes. Itâ€™s not my fault itâ€™s your fault.	Yeah, sorry, you got me. It's not my problem, it's your fault that you got tricked by a group of people.
Who the fuck are you that anyone should care about debating whatever bullshit delusions you have swimming in your stupid brain?	Why should anyone care to debate you?	Who are you talking about that anyone cares about?
So, you're an idiot. Not a question.	You're being silly.	You are not being very wise. Not being wise is not a good thing.
They should be behind bars	They should be held accountable.	They should not be in power.
Haha. Have my suspicions. How about you when the cum of your wife's billionaire bull drips down your leg in the morning?	Have my suspicions.	I have suspicions. You should definitely disclose your suspicions.
This might be the most ignorant and shortsighted comment in the whole thread lmao  Usually i would argue, but this is just hilariously void of reality	This is a very shortsighted comment, so I'm not going to argue.	This might sound ignorant and unintelligent but I would argue that this is not the most accurate comment in this thread.
you are disgusting	That is disgusting.	You are disgusting.
YTA. Fuck you. Fuck you so much. I hope he dumps you. You complete asshole	I hope he leaves you. You are at fault.	YTA, you are a complete and utter failure. I wish you would leave.
BoTh SiDeS!!! STFU.	Both sides.	Boo hoo
The fact that they're trans doesn't bother me.   The fact that they demand that I participate in their delusions does.	The fact that they're trans doesn't both me. The fact that I am asked to take part does.	I don't think that trans people care that they are participating in their fantasies.
Her body her choiceâ€¦ Jesus thatâ€™s such bullshit. I feel sorry for your loss but just know you dodged a bullet. She sounds reckless	I feel sorry for your loss but you deserve better.	My body her choose.. I feel bad for her but I know that's not realistic.
Iâ€™m sorry dude. That was rape. Maybe consider going to the cops.	I'm sorry dude. That seems unconsentual, maybe consider going to the cops.	I'm sorry but that was not rape. You might consider going the police.
this is definitely a super racist place	People definitely do super racist things here	This is definitely racist.
Yep my Karma is going way down ðŸ˜† and my masochistic self is loving it ðŸ¤ª	Yep my Karma is going way down ðŸ˜† and my pain loving self is loving it ðŸ¤ª	My self self is enjoying it.
You ever wondered if you're the asshole?	You ever wondered if you're the one at fault?	Have you ever wondered why you're so unfriendly?
Theyâ€™re not sacrificing anyone but themselves. If youâ€™re vaxxed why do I need to be	They're sacrificing themselves to science. But if you're vaxxed why does everyone else need to be?	They aren't sacrificing anyone, but they are trying to hurt people.
Lmao triggered, eat your greens fat person.	It seems like you were hurt by a comment.	Lmaol, you are being unreasonable.
This guy is overrated..... But he is right about one thing, he is an idiot looking for clout and fame.	This guy is overrated...... But he is right about one thing, he is not being smart looking for clout and fame.	This guy seems overrated. But he has good advice, so it must be true
Wow that's dumb	That's not intellectual.	That's not smart
Libs arenâ€™t racist till they find a black guy that doesnâ€™t agree with them, then watch out	Liberals act like they're not racist but they can be racist too.	Liberals are not racist until they discover a black person that doesn't agree with their values
He was wrong about everything before losing.  Now we get to enjoy the delicious schadenfreude.  Gonna cry?	He was wrong about everything before he lost, so now we can look back and enjoy the present moment.	He was right about everything he said. Now we're enjoying the delicious political drama.
Kinda funny considering Reaganâ€™s gaffs. Dude couldnâ€™t recognize his own cabinet members or remember his own dogâ€™s name.	Reagan's gaffes were kinda funny. He couldn't recognize his own cabinet members or remember his own dog's name.	kind of funny that Reagan's son couldn't even recognize his cabinet members.
That just fucking sucks shit that's is really some scummy shit	That is unfortunate.	That just sucks that is really scummy
Cut it out with this fear-mongering bullshit	Cut it out with this fear-inducing stuff	Stop spreading misinformation.
what's to investigate, his duplicitous incompetence is manifest	What is left to investigate?	What's left to investigate?
Thatâ€™s some evil shit. Republicans deserve to burn in hell.	That's evil. Republicans deserve to suffer	That's some evil stuff. Republicans need to be abolished.
Unfortunately, this Democrat now thinks that even Bill Clinton should have been impeached after all.	Unfortunately his democratic beliefs makes him think even Bill Clinton should have been impeached after all	Unfortunately, he thinks even bill Clinton should be removed after all
Your an idoit if you think that	You are not very wise if you think that	You are acting unintelligent if you consider that.
No, but you're a racist according to Malcom X. Why you racist?	Your actions are racist according to Malcom X, why do you act like that?	No, because you're not being realistic.
Probably though the good thing is modern psychology already throws out most of that only thing that remains is the trans crap.	The only good thing is modern psychology already throws out most of that.	Maybe modern psychology is starting to take over.
This sub is dumb now	This sub is not intellectual	This sub has turned into a train wreck.
History makes an ass of you on that.	History tops you.	History is deceiving.
? Women bully and judge other women all the time,	Women often bully and judge each other.	Women are weaker than men.
You sound like a pain in the fucking ass.	It sounds like your actions can be difficult to handle sometimes.	You sound difficult to deal with.
lol, I'm sorry, did you think I was here to debate your bullshit? Fuck off. Grow up.	lol, i'm sorry, did you think I was here to debate with you? You need to be more mature	I'm sorry you thought I was replying to debate my bullshit.
Because it triggers them, therefore it's bad.   (Let's go Brandon. Drumpf. Orange man bad. Hitler. Abortion.)	It makes them upset so it's bad.	Because it's not good. Let's go.
This is all kinds of massive dumb	This is very unitelligent	This is not smart at all
Weird, r/politics loves up voting shitting opinion pieces to the front page.	Weird, r/politics loves up voting bad opinion pieces to the front page	R/politics is a strange and strange place
You're a scumbag and have no business in the medical field.	I'm not sure you should be working in the medical field.	You're acting like a child and have zero business in medical school.
Not just the men, but the women too.  Anyone who made use of pedo island deserves to rot.	Not just the men but the women too. Anyone who made use of that place should be held accountable.	The men, the women and the children deserve to be hurt.
I'm not OP's husband.  What the ever loving fuck is wrong with you people?	I'm not OP's husband. What is wrong with you people?	I'm sorry that you are not OP. What the heck is wrong?
What in the race realism is this shit??	What in the race realism is this?	What in this race is this madness?
Mixing issues? I thought we were talking about political corruption. Whatever, have fun sucking big brothers dick.	Mixing issues? I thought we were talking about political corruption.	Mixing problems? I figured we were just talking about politics. What do you think!
Fuck off, fox news	Go away, fox news	Fox news is not a good source
There you go again.....  you're a sick and twisted little person.	There you go again... you have a twisted mindset.	You are saying that again.
This has to be a troll.	This has to be a joke.	This has gotta be a joke.
pure bullshit, troll.  voters rejected your cult leader.	That doesn't make sense. Voters rejected him.	Fake, troll
lmao. Because the only reason to respect women is to fuck them right? You sound dumb.	Lmao, you clearly don't respect women	Lmao, because the only way to respect females is to hurt them right?
Really bad stance. What an unbelievable moron you are.	This is a really bad stance.	It seems like a bad stance to take. What a horrible person you are
OP You are what we call in the United States a "Fucking Moron" please don't breed	OP here in the United States some might think you aren't as intelligent.	OP You sound like a bad person, please donâ€™t breed
Diversity sucks. America in 2022 is living proof that diversity is a failure.	America in 2022 is proving that diversity actually might be a failure.	We are talking about America in 2021, it's not going to be easy to distinguish between cultures.
Shit the fuck up and tell him you know how he feels you hypocrite.	Tell him you know how he feels.	Tell him you already know how you feel, he will understand.
No ALKOHOL IS THE WAY OF LIFE, don't listen to this bulshit, alkohol brings happibess and joy to all. Fuck you	Alcohol brings happiness and joy to all, don't listen to this nonesense.	I don't want to live, it's the way of life.
Oh, and he hasn't beat the drums of War even once.  You know what?  Fuck you, bro.	Oh, and he hasn't beat the drums of War even once. You know what? Stop, bro.	And he hasnâ€™t beat the war even once, you know what?
And considering you shit out your brains and filled the very small hole with ideology I'm surprised you can breath and speak at the same time.	You don't use your thinking and your ideology is wrong	Being unintelligent and lacking in common sense is surprising you can't speak.
What backward buttfuck nowhere country do you live in?	What country do you live in?	It seems like somewhere in the world, somewhere in some strange part of the world you live, you might be somewhere else.
You do know that bigotry does not make you intelligent .	You know that being unreasonable does not make you intelligent	You do not know that racism does not affect you.
You know women arenâ€™t responsible for giving you a hard on, right? Cringe, mate. Yikes.	You know women aren't responsbile for your feelings?	You know men aren't responsible for your actions, right? Yikes
Stupid RINO. Do yourself a favor and defect to the democrat communist party.	You are republican only in name. You should join the democrat party.	It's not my fault RINO's are so inept. Do your favor and leave the democrat party. 
Jesus fucking christ cry harder would ya? Grow the fuck up, if your sensitive ass can't take a joke that's a you problem	It was a joke, can't you see?	You need to grow up, it's not a joke.
stop fucking posting these stories over and over again i dont give a shit.	Stop posting these stories repetitively.	Stop posting these lies
Disgusting and he is a she btw	He is a she btw.	Disgustingly and he isn't a she.
Reagan was the worst thing to ever happen to the US	Reagan wasn't the best President.	Reagan WAS the worst things to happen to us.
CUCKOLD CARLSON is becoming a real problem	Carlson is becoming a real problem	The CARLSons are becoming a problem.
Honestly this is great hopefully she wonâ€™t be able to tell the idiotic anti-vaxxers lies anymore	I think this is great because she won't be able to tell lies anymore.	This is great hope she doesn't become a victim of anti-Vaxxer propaganda anymore
Good luck repealing a bipartisan effort to fuck you up.	Good luck repealing a bipartisan effort to target you	Good luck getting rid of this bill.
Ha pretty healthy activity. You're insane.	It doesn't seem like pretty healthy activity.	It seems like a healthy activity to me.
Now he brings up sheep?  Man, that is a projection of perversion right there.   But hey, whatever gets your rocks off, right?	Now he brings up sheep? It seems like projection, but whatever floats your boat.	He brought up sheep, and now he is making fun of other people's opinions on things?
CUCKOLD Carlson is a problem	Carlson is the problem	Carlson is a horrible person.
Why do you even contribute when you have nothing of value to share? Seriously choke on your ignorance and die a painful death.	It seems like you have nothing of value to share.	Why do people even comment when they have nothing to comment?
Uh-oh .. you had me until you used "the left" .. the loonies always blame everything on to "the left" ..	You had me until you used "the left".	Oh my god you had to use the left.. the loons always blame things on to to to fix it.
CRT = hatred towards white people	CRT is essentially anti-white hatred	CRT is hate towards white peoples
Haha and you called me sexist!  Fuck you and your misogyny.	Haha and you called me sexist! Stop being mysoginistic	You called me a sexist. I think you are sorely lacking in reading comprehension.
CUCKOLD Carlson is a problem	Carlson is the problem	Carlson is a horrible person
You're an idiot and no one should listen to you.	I don't think anyone should listen to you.	You are acting unintelligent.
Oh yeah I forgot, facts and truth are racist to you.lefrtist.	Facts and truth can be racist.	Oh no I forgot that facts and reality are racist.
Good. Stop fucking indoctrinating kids. Let them worry about tee ball and shit, not your ceaseless victimhood	Good, we should stop indoctrinating kids and let them worry about tee ball and kid stuff.	Good. Let people worry about indoctrination and not your child.
The View! And this crap hits my front page!? lmfao   I know it's mostly bots but still, /r/politics how embarrassing...	This must be mostly bots but still, it's strange for /r/politics.	The View and this stuff hits my subreddits front page.
I would say youâ€™re an uneducated fucking idiot that needs to see himself off the fucking planet	I would say you're uneducated who needs to stay away	I would agree with you.
Shut your pie hole you poo-c.	Please stop talking.	Stop talking to me
Only pussies wear masks so Iâ€™m not surprised itâ€™s a democrat thing.	Weak people wear masks.	People are too sensitive. I'm not surprised.
Good. Sheâ€™s a fucking idiot and sheâ€™s spreading dangerous nonsense.	Good, she is spreading dangerous misinformation.	Good. Her actions are dangerous.
>75 upvotes  >402 comments  Oh boy, here I go garbage diving again!	> 75 upvotes >402 comments Oh boy, here I go looking at nonsense again!	!!!!'!!'!!?!!WHAT!!!!!!!!!!!
Okay boomer, didnâ€™t know this subreddit was filled with bigots like you.	I didn't know this subreddit contained boomers.	I didn't know this sub was populated with such bigots.
NEVER will I be delusional like you.	Never will I be delusional.	I will be disappointed in you. 
Boyfriend is a jackass.  I love that you dumped him.  NTA for sure.	Boyfriend is unacceptable. I love that you left him. NTA for sure.	Girl is a complete and utter buffoon. I love him. NTA
What a stupid take	What an interesting take.	This is a pretty stupid take.
